0,0,0,0,0,0,0,0,24,13,14,15,13,13,15,24,22,23,25,14,15,15,13,13,14,13,15,14,14,15,13,15,13,14,13,13,24,22,23,25,15,14,14,15,13,13,14,15,15,14,24,25,0,0,0,0,0,0,0,0
0,0,0,0,0,0,0,0,23,4,6,5,4,5,5,4,17,18,6,6,5,4,4,5,6,6,4,5,4,4,6,5,5,6,4,4,5,16,17,6,4,5,5,6,6,4,4,5,6,4,4,22,0,0,0,0,0,0,0,0
0,0,0,0,0,0,0,0,19,7,7,9,8,7,9,9,25,24,7,8,9,8,8,9,7,9,9,7,8,7,7,7,8,9,9,7,9,17,17,8,8,7,8,9,9,7,9,8,8,8,7,16,0,0,0,0,0,0,0,0
0,0,0,0,0,0,0,0,19,8,7,8,7,7,8,9,6,5,8,7,7,9,9,8,7,8,8,7,7,8,9,9,9,7,7,8,8,17,18,9,9,9,7,7,8,8,8,7,7,9,8,17,0,0,0,0,0,0,0,0
0,0,0,0,0,0,0,0,20,1,2,3,2,1,2,3,8,7,2,2,3,2,1,2,2,1,2,1,2,3,1,3,3,1,2,3,1,18,16,3,2,1,3,2,3,2,1,3,3,2,1,17,0,0,0,0,0,0,0,0
0,0,0,0,0,0,0,0,21,1,2,22,10,23,1,2,8,9,3,1,22,23,2,3,1,2,3,22,10,23,2,1,3,2,2,1,2,16,16,3,2,2,1,2,2,3,3,1,2,3,2,18,0,0,0,0,0,0,0,0
0,0,0,0,0,0,0,0,21,2,3,25,14,24,3,3,2,3,3,3,16,20,3,2,3,2,1,25,15,24,3,2,1,2,3,2,2,25,24,1,3,3,2,3,1,2,2,2,3,3,3,16,0,0,0,0,0,0,0,0
0,0,0,0,0,0,0,0,19,2,2,5,5,6,3,2,1,2,1,2,17,20,3,1,3,2,3,5,5,6,3,2,2,3,1,2,3,6,4,2,2,1,2,2,2,2,3,1,2,2,3,16,0,0,0,0,0,0,0,0
0,0,0,0,0,0,0,0,20,2,1,8,8,9,2,1,2,2,3,2,17,20,2,2,2,2,2,7,8,8,2,3,2,1,2,3,2,7,8,2,3,2,3,1,22,11,23,2,3,1,3,17,0,0,0,0,0,0,0,0
0,0,0,0,0,0,0,0,21,3,2,9,7,7,2,2,22,23,2,3,18,19,3,3,3,1,2,8,7,9,1,3,1,2,3,2,3,7,9,1,3,2,3,2,25,14,24,2,3,2,2,18,0,0,0,0,0,0,0,0
0,0,0,0,0,0,0,0,20,2,2,3,2,2,1,3,17,20,2,3,25,24,2,3,2,3,2,1,2,2,2,2,3,3,3,1,3,2,3,3,2,3,3,3,4,4,5,3,2,2,1,18,0,0,0,0,0,0,0,0
0,0,0,0,0,0,0,0,20,2,3,2,3,1,3,3,25,24,1,2,5,6,2,2,2,3,1,3,3,1,2,2,2,1,3,2,3,2,1,3,2,3,1,2,8,8,9,3,1,3,2,18,0,0,0,0,0,0,0,0
0,0,0,0,0,0,0,0,24,10,10,12,11,11,12,12,11,23,3,3,7,8,1,2,22,12,11,10,10,11,12,23,2,2,22,23,2,3,2,22,23,1,2,2,9,9,7,3,2,2,2,16,0,0,0,0,0,0,0,0
0,0,0,0,0,0,0,0,22,15,15,14,14,13,13,14,15,24,3,2,7,8,2,1,25,15,15,14,13,13,15,24,3,2,25,24,1,2,2,17,20,3,3,2,1,2,3,1,2,2,3,17,0,0,0,0,0,0,0,0
0,0,0,0,0,0,0,0,25,5,6,6,4,5,5,4,6,4,3,2,3,3,2,3,6,6,6,4,5,4,4,6,1,3,4,4,2,1,3,25,24,2,2,2,2,1,3,2,3,3,2,25,0,0,0,0,0,0,0,0
0,0,0,0,0,0,0,0,23,7,8,8,9,7,9,9,7,8,2,2,2,1,2,2,8,9,9,8,7,7,7,8,2,2,7,8,2,2,1,22,12,10,11,11,23,2,3,22,10,10,11,23,0,0,0,0,0,0,0,0
0,0,0,0,0,0,0,0,19,8,9,9,8,8,9,7,7,8,2,3,1,3,3,2,7,7,8,9,8,8,7,9,1,2,7,7,1,3,2,25,13,14,14,15,24,3,2,25,14,14,15,24,0,0,0,0,0,0,0,0
0,0,0,0,0,0,0,0,20,2,3,2,2,3,3,2,2,2,3,1,22,23,2,3,2,1,3,2,3,1,2,3,3,2,2,1,3,2,3,4,4,5,6,4,5,2,1,5,5,4,6,22,0,0,0,0,0,0,0,0
0,0,0,0,0,0,0,0,20,1,2,3,1,2,3,1,3,1,2,2,25,24,1,3,2,2,2,1,2,2,2,2,3,1,2,3,3,3,1,7,9,9,8,8,7,2,2,7,8,8,9,16,0,0,0,0,0,0,0,0
0,0,0,0,0,0,0,0,19,2,1,22,10,11,12,12,11,23,2,2,6,6,2,2,1,2,3,2,2,3,1,2,22,10,13,2,3,2,2,7,7,8,9,8,7,1,2,9,7,7,8,16,0,0,0,0,0,0,0,0
0,0,0,0,0,0,0,0,19,2,2,25,13,13,15,14,15,24,1,3,9,9,1,2,3,3,3,3,2,3,3,2,25,15,24,2,2,2,1,2,3,3,2,1,2,2,3,2,3,3,1,17,0,0,0,0,0,0,0,0
0,0,0,0,0,0,0,0,21,3,2,6,5,5,4,4,5,6,3,3,7,7,2,2,3,2,3,1,3,2,3,3,6,5,5,1,2,2,2,2,1,2,3,2,3,3,2,3,1,2,2,17,0,0,0,0,0,0,0,0
0,0,0,0,0,0,0,0,20,2,3,8,8,7,9,9,9,7,2,2,3,2,1,3,2,2,2,2,3,3,2,2,8,9,8,2,3,3,2,3,2,3,3,2,2,1,3,2,3,3,2,25,0,0,0,0,0,0,0,0
0,0,0,0,0,0,0,0,21,1,2,8,7,9,9,7,7,8,2,1,2,2,3,2,22,10,11,12,10,23,2,1,8,7,7,3,2,22,11,12,12,10,12,11,11,10,12,10,10,11,11,23,0,0,0,0,0,0,0,0
0,0,0,0,0,0,0,0,19,2,1,2,3,3,2,2,2,3,3,3,2,1,2,3,25,13,13,14,15,24,2,2,3,3,1,2,1,25,13,14,13,15,15,13,15,14,14,13,15,14,15,24,0,0,0,0,0,0,0,0
0,0,0,0,0,0,0,0,24,2,3,2,3,1,2,1,3,2,1,3,2,2,1,2,5,5,4,4,22,23,3,3,2,2,2,3,2,6,6,5,5,4,5,4,4,4,6,5,4,5,6,22,0,0,0,0,0,0,0,0
0,0,0,0,0,0,0,0,22,10,11,12,12,11,10,23,2,2,2,3,1,3,2,3,7,8,8,9,18,21,2,2,1,3,3,1,3,8,8,9,7,7,7,9,8,9,7,8,7,9,9,18,0,0,0,0,0,0,0,0
0,0,0,0,0,0,0,0,25,14,13,13,14,14,15,24,2,1,2,2,22,23,2,1,7,7,7,8,25,24,1,3,2,22,23,2,2,7,9,8,9,8,8,8,7,7,9,8,7,7,8,18,0,0,0,0,0,0,0,0
0,0,0,0,0,0,0,0,4,6,4,5,5,4,4,4,3,2,3,2,16,19,3,2,2,3,3,3,5,6,2,3,3,16,19,3,2,2,3,3,1,3,2,2,3,1,2,3,2,3,3,16,0,0,0,0,0,0,0,0
0,0,0,0,0,0,0,0,8,8,9,9,8,7,7,7,2,3,3,2,17,20,3,2,1,3,2,1,9,9,2,3,1,17,20,3,1,3,1,2,3,2,3,3,2,2,2,1,2,2,3,17,0,0,0,0,0,0,0,0
0,0,0,0,0,0,0,0,8,9,7,8,9,9,7,8,3,3,1,3,18,20,1,2,3,2,2,3,9,8,1,2,2,18,21,2,3,2,3,3,3,1,2,22,23,3,1,3,3,3,2,17,0,0,0,0,0,0,0,0
0,0,0,0,0,0,0,0,2,2,2,1,2,2,3,3,2,2,2,3,18,21,2,3,3,1,3,2,2,3,3,2,3,17,21,1,2,3,3,1,2,2,3,16,19,2,2,2,3,2,2,17,0,0,0,0,0,0,0,0
0,0,0,0,0,0,0,0,2,1,3,2,3,3,1,2,2,1,2,3,25,24,2,3,2,2,2,3,1,2,3,1,2,25,24,2,3,2,2,3,2,3,3,25,24,3,1,3,2,2,1,16,0,0,0,0,0,0,0,0
